#########
#S..#...#
#.##.#.#E
#...#...#
#########
